0011111111111111011111
1000011111111000000111
1011011111111011011011
1001100000011011011011
1101111111011011011011
1101111111000011111011
1100000111111111111011
1111110111111111000011
1111110111000000011111
0000001111011111111111
1111111111000000000000